A	AH
A(2)	EY
ARE	AA R
ARE(2)	ER
BORN	B AO R N
CHATBOT	CH AE T B AH T
DO	D UW
GIRLFRIEND	G ER L F R EH N D
HAVE	HH AE V
INDIA	IH N D IY AH
IS	IH Z
JAVA	JH AA V AH
MARRIED	M EH R IY D
NAME	N EY M
THE	DH AH
THE(2)	DH IY
TIME	T AY M
WERE	W ER
WHAT	W AH T
WHAT(2)	HH W AH T
WHEN	W EH N
WHEN(2)	HH W EH N
WHEN(3)	W IH N
WHEN(4)	HH W IH N
YOU	Y UW
YOUR	Y AO R
YOUR(2)	Y UH R
